############################
#............##............#
#.####.#####.##.#####.####.#
#*####.#####.##.#####.####*#
#.####.#####.##.#####.####.#
#..........................#
#.####.##.########.##.####.#
#.####.##.########.##.####.#
#......##....##....##......#
######.##### ## #####.######
######.##### ## #####.######
     #.##    g     ##.#     
     #.## ######## ##.#     
######.## #      # ##.######
     #.   #  l   #   .#     
######.## #      # ##.######
     #.## ######## ##.#     
     #.##    p     ##.#     
######.## ######## ##.######
######.## ######## ##.######
#............##............#
#.####.#####.##.#####.####.#
#*####.#####.##.#####.####*#
#...##.......##.......##...#
###.##.##.########.##.##.###
###.##.##.########.##.##.###
#......##....##....##......#
#.##########.##.##########.#
#.##########.##.##########.#
#..........................#
############################